NO caca
SO boubou

EA kiki
WE pipi
F ta chatte
C lol

11111111111
10000000001    1111111
1000000000111111000001    111111
1000000000000000000001    100001
1111111111111111111111    111111


1111
110111
1111
