NO     include/parsing.h 
SO 
include/parsing.h



EA include/parsing.h



WE include/parsing.h

F 1,2,3
C   64,5,  65

111 1111111
1N1 111000111111 111
111 1100111      101
    1000001      11111111
11111000001
10001111111
11111