1111111111111111111111111111
100000000000000000000000111111
111000000000000000000001111111111
1000000000000000000000000000001
10000000000000000000000000000011
10000001000000110000000001011111
10000001000000110000000001011111
10000001000000110000000001011111
10000001000000110000000001011111
10000001000000110000000001011111
1111111111111111111111111111