NO     include/parsing.h 
SO include/parsing.h


EA include/parsing.h



WE include/parsing.h

F 1,2,3
C   64,5,  65

1111111
10Q0N11
1111111