NO     include/parsing.h 
SO include/parsing.h


EA include/parsing.h



WE include/parsing.h

F 1,2,3
C   64,5,  65

111111            1111111
1000N11111111111111000001
1111100000000000001000001
    111111110000000000011
           10000000111111
           111111111